{
 "name": "arena",
 "tileSize": 8,
 "legend": {
  "#": "rockTop",
  "=": "rock",
  "-": "platform"
 },
 "tiles": [
  "........................................................................................................................",
  "........................................................................................................................",
  "........................................................................................................................",
  "........................................................................................................................",
  "........................................................................................................................",
  "........................................................................................................................",
  "........................................................................................................................",
  "........................................................................................................................",
  "........................................................................................................................",
  "........................................................................................................................",
  "........................................................................................................................",
  "........................................................................................................................",
  "........................................................................................................................",
  "........................................................................................................................",
  "........................................................................................................................",
  ".....................................--------...........................................................................",
  "........................................................................................................................",
  "........................................................................................................................",
  "........................................................................................................................",
  "...................................................------------.........................................................",
  "........................................................................................................................",
  "........................................................................................................................",
  "........................................................................................................................",
  ".................----------...........................................................----------........................",
  "........................................................................................................................",
  "........................................................................................................................",
  "........................................................................................................................",
  "........................................................................................................................",
  "........................................................................................................................",
  "########################################################################################################################",
  "========================================================================================================================",
  "========================================================================================================================",
  "========================================================================================================================",
  "========================================================================================================================"
 ],
 "playerSpawn": {
  "x": 230,
  "y": 192
 },
 "entities": [],
 "props": {
  "waves": "default"
 },
 "triggers": [
  {
   "x": 180,
   "y": 140,
   "w": 110,
   "h": 92,
   "event": "talk",
   "once": true,
   "props": {
    "conversation": "intro"
   }
  }
 ]
}