{
 "name": "arena",
 "tileSize": 8,
 "legend": {
  "#": "rockTop",
  "=": "rock",
  "-": "platform",
  "D": "gate"
 },
 "tiles": [
  "........................................................................................................................",
  "........................................................................................................................",
  "........................................................................................................................",
  "........................................................................................................................",
  "........................................................................................................................",
  "........................................................................................................................",
  "........................................................................................................................",
  "........................................................................................................................",
  "........................................................................................................................",
  "........................................................................................................................",
  "........................................................................................................................",
  "........................................................................................................................",
  "........................................................................................................................",
  "........................................................................................................................",
  "........................................................................................................................",
  ".....................................--------...........................................................................",
  "........................................................................................................................",
  "........................................................................................................................",
  "........................................................................................................................",
  "...................................................------------.........................................................",
  "........................................................................................................................",
  "........................................................................................................................",
  "........................................................................................................................",
  ".................----------...........................................................----------........................",
  "........................................................................................................................",
  "....................................................................................................................DD..",
  "....................................................................................................................DD..",
  "....................................................................................................................DD..",
  "....................................................................................................................DD..",
  "########################################################################################################################",
  "========================================================================================================================",
  "========================================================================================================================",
  "========================================================================================================================",
  "========================================================================================================================"
 ],
 "playerSpawn": {
  "x": 230,
  "y": 192
 },
 "entities": [],
 "props": {
  "waves": "default",
  "waveGoal": 5,
  "gateKey": "gate-key"
 },
 "triggers": [
  {
   "x": 180,
   "y": 140,
   "w": 110,
   "h": 92,
   "event": "talk",
   "once": true,
   "props": {
    "conversation": "intro"
   }
  },
  {
   "x": 928,
   "y": 200,
   "w": 16,
   "h": 32,
   "event": "door",
   "once": false,
   "props": {
    "room": "cavern",
    "x": 28,
    "y": 200,
    "key": "gate-key"
   }
  }
 ]
}