{
  "name": "arena",
  "tileSize": 8,
  "legend": {
    "#": "rockTop",
    "=": "rock",
    "-": "platform",
    "D": "gate",
    "O": "portal"
  },
  "tiles": [
    "........................................................................................................................",
    "........................................................................................................................",
    "........................................................................................................................",
    "........................................................................................................................",
    "........................................................................................................................",
    "........................................................................................................................",
    "........................................................................................................................",
    "........................................................................................................................",
    "........................................................................................................................",
    "........................................................................................................................",
    "........................................................................................................................",
    "........................................................................................................................",
    "........................................................................................................................",
    "........................................................................................................................",
    "........................................................................................................................",
    ".....................................--------...........................................................................",
    "........................................................................................................................",
    "........................................................................................................................",
    "........................................................................................................................",
    "...................................................------------.........................................................",
    "........................................................................................................................",
    "........................................................................................................................",
    "........................................................................................................................",
    ".................----------...........................................................----------........................",
    "........................................................................................................................",
    "..........OO...........................................................................................................D",
    "..........OO...........................................................................................................D",
    "..........OO...........................................................................................................D",
    "..........OO...........................................................................................................D",
    "########################################################################################################################",
    "========================================================================================================================",
    "========================================================================================================================",
    "========================================================================================================================",
    "========================================================================================================================"
  ],
  "playerSpawn": {
    "x": 230,
    "y": 192
  },
  "entities": [],
  "props": {
    "music": "overworld",
    "waves": "default",
    "waveGoal": 5,
    "gateKey": "gate-key",
    "map": {
      "x": 0,
      "y": 2
    }
  },
  "triggers": [
    {
      "x": 180,
      "y": 140,
      "w": 110,
      "h": 92,
      "event": "talk",
      "once": true,
      "props": {
        "conversation": "intro"
      }
    },
    {
      "x": 952,
      "y": 200,
      "w": 8,
      "h": 32,
      "event": "door",
      "once": false,
      "props": {
        "room": "cavern",
        "key": "gate-key"
      }
    },
    {
      "x": 78,
      "y": 196,
      "w": 24,
      "h": 36,
      "event": "portal",
      "once": false,
      "props": {}
    }
  ]
}
