{
  "name": "mountain",
  "tileSize": 8,
  "legend": {
    "#": "rockTop",
    "=": "rock",
    "-": "platform",
    "D": "gate"
  },
  "tiles": [
    "=..........................................=",
    "=..........................................=",
    "=..........................................=",
    "=..........................................=",
    "=..........................................=",
    "=.............................------------.=",
    "=..........................................=",
    "=..........................................=",
    "=..........................................=",
    "=......................--------............=",
    "=..........................................=",
    "=..........................................=",
    "=..........................................=",
    "=...............--------...................=",
    "=..........................................=",
    "=..........................................=",
    "=..........................................=",
    "=........--------..........................=",
    "=..........................................=",
    "=..........................................=",
    "=..........................................=",
    "=.--------.................................=",
    "=..........................................=",
    "=..........................................=",
    "=..........................................=",
    "=.--------.................................=",
    "=..........................................=",
    "=..........................................=",
    "=..........................................=",
    "=........--------..........................=",
    "=..........................................=",
    "=..........................................=",
    "=..........................................=",
    "=...............--------...................=",
    "=..........................................=",
    "=..........................................=",
    "=..........................................=",
    "=......................--------............=",
    "=..........................................=",
    "=..........................................=",
    "=..........................................=",
    "=.............................--------.....=",
    "=..........................................=",
    "=..........................................=",
    "=..........................................=",
    "=.............................--------.....=",
    "=..........................................=",
    "=..........................................=",
    "=..........................................=",
    "=......................--------............=",
    "=..........................................=",
    "=..........................................=",
    "=..........................................=",
    "=...............--------...................=",
    "=..........................................=",
    "=..........................................=",
    "=..........................................=",
    "=........--------..........................=",
    "=..........................................=",
    "=..........................................=",
    "=..........................................=",
    "=.--------.................................=",
    "=..........................................=",
    "=..........................................=",
    "=..........................................=",
    "############################################",
    "============================================",
    "============================================"
  ],
  "playerSpawn": {
    "x": 24,
    "y": 494
  },
  "entities": [],
  "triggers": [
    {
      "x": 8,
      "y": 488,
      "w": 8,
      "h": 32,
      "event": "door",
      "once": false,
      "props": {
        "room": "town"
      }
    },
    {
      "x": 336,
      "y": 8,
      "w": 8,
      "h": 32,
      "event": "door",
      "once": false,
      "props": {
        "room": "ramparts"
      }
    }
  ],
  "props": {
    "map": {
      "x": 16,
      "y": 0
    }
  }
}
