{
  "name": "ramparts",
  "tileSize": 8,
  "legend": {
    "#": "rockTop",
    "=": "rock",
    "-": "platform",
    "D": "gate"
  },
  "tiles": [
    "=........................................................................................=",
    "=........................................................................................=",
    "=........................................................................................=",
    "=........................................................................................=",
    "=........................................................................................=",
    "=........................................................................................=",
    "=........................................................................................=",
    "=........................................................................................=",
    "=........................................................................................=",
    "=........................................................................................=",
    "=........................................................................................=",
    "=........................................................................................=",
    "=........................................................................................=",
    "=........................................................................................=",
    "=........................................................................................=",
    "=........................................................................................=",
    "=........................................................................................=",
    "=........................................................................................=",
    "=........................................................................................=",
    "=........................................................................................=",
    "=.................-------.......................................-------..................=",
    "=........................................................................................=",
    "=.DD.....................................................................................=",
    "=.DD.....................................................................................=",
    "=.DD.....................................................................................=",
    "=.DD.....................................................................................=",
    "=########################################################################################=",
    "==========================================================================================",
    "==========================================================================================",
    "=========================================================================================="
  ],
  "playerSpawn": {
    "x": 56,
    "y": 170
  },
  "entities": [
    {
      "type": "duelist",
      "x": 560,
      "y": 172
    }
  ],
  "props": {
    "music": "depths",
    "map": {
      "x": 11,
      "y": 0
    }
  },
  "triggers": [
    {
      "x": 12,
      "y": 176,
      "w": 24,
      "h": 32,
      "event": "door",
      "once": false,
      "props": {
        "room": "town"
      }
    },
    {
      "x": 48,
      "y": 150,
      "w": 70,
      "h": 60,
      "event": "talk",
      "once": true,
      "props": {
        "conversation": "ramparts-entry"
      }
    }
  ]
}
