{
 "name": "test_room",
 "tileSize": 8,
 "legend": {
  "#": "rockTop",
  "=": "rock",
  "-": "platform",
  "I": "rock"
 },
 "tiles": [
  "I..............................................................................I",
  "I..............................................................................I",
  "I..............................................................................I",
  "I..............................................................................I",
  "I..............................................................................I",
  "I..............................................................................I",
  "I..............................................................................I",
  "I..............................................................................I",
  "I..............................................................................I",
  "I..............................................................................I",
  "I..............................................................................I",
  "I..............................................................................I",
  "I..............................................................................I",
  "I..............................................................................I",
  "I..............................................................................I",
  "I.....................---------..................---------.....................I",
  "I..............................................................................I",
  "I..............................................................................I",
  "I..............................................................................I",
  "I..................................----------..................................I",
  "I..............................................................................I",
  "I..............................................................................I",
  "I..............................................................................I",
  "I............---------....................................---------............I",
  "I..............................................................................I",
  "I..............................................................................I",
  "I..............................................................................I",
  "################################################################################",
  "================================================================================",
  "================================================================================",
  "================================================================================",
  "================================================================================"
 ],
 "playerSpawn": {
  "x": 320,
  "y": 180
 },
 "entities": [
  {
   "type": "spawner",
   "x": 260,
   "y": 180
  }
 ],
 "props": {},
 "triggers": []
}
