{
  "name": "throne",
  "tileSize": 8,
  "legend": {
    "#": "rockTop",
    "=": "rock",
    "-": "platform",
    "D": "gate",
    "O": "portal"
  },
  "tiles": [
    "================================================================================",
    "================================================================================",
    "................................................................................",
    "................................................................................",
    "................................................................................",
    "................................................................................",
    "................................................................................",
    "................................................................................",
    "................................................................................",
    "................................................................................",
    "................................................................................",
    "................................................................................",
    "................................................................................",
    "................................................................................",
    "................................................................................",
    "..................................-------------.................................",
    "................................................................................",
    "................................................................................",
    "................................................................................",
    "................................................................................",
    "................................................................................",
    "........-------...................................................-------.......",
    "................................................................................",
    "................................................................................",
    "................................................................................",
    "..DD......OO.................................................................DD.",
    "..DD......OO.................................................................DD.",
    "..DD......OO.................................................................DD.",
    "..DD......OO.................................................................DD.",
    "################################################################################",
    "================================================================================",
    "================================================================================",
    "================================================================================",
    "================================================================================"
  ],
  "playerSpawn": {
    "x": 40,
    "y": 216
  },
  "entities": [
    {
      "type": "slime-king",
      "x": 420,
      "y": 180
    }
  ],
  "triggers": [
    {
      "x": 8,
      "y": 200,
      "w": 20,
      "h": 32,
      "event": "door",
      "once": false,
      "props": {
        "room": "cavern"
      }
    },
    {
      "x": 100,
      "y": 140,
      "w": 60,
      "h": 100,
      "event": "talk",
      "once": true,
      "props": {
        "conversation": "boss-intro"
      }
    },
    {
      "x": 608,
      "y": 196,
      "w": 24,
      "h": 36,
      "event": "door",
      "once": false,
      "props": {
        "room": "town",
        "flag": "bossDefeated",
        "lockedText": "SEALED BY THE KING'S POWER"
      }
    },
    {
      "x": 78,
      "y": 196,
      "w": 24,
      "h": 36,
      "event": "portal",
      "once": false,
      "props": {}
    }
  ],
  "props": {
    "music": "depths",
    "map": {
      "x": 8,
      "y": 2
    }
  }
}
