{
 "name": "town",
 "tileSize": 8,
 "legend": {
  "#": "rockTop",
  "=": "rock",
  "-": "platform",
  "D": "gate"
 },
 "tiles": [
  "................................................................................",
  "................................................................................",
  "................................................................................",
  "................................................................................",
  "................................................................................",
  "................................................................................",
  "................................................................................",
  "................................................................................",
  "................................................................................",
  "................................................................................",
  "................................................................................",
  "................................................................................",
  "................................................................................",
  "................................................................................",
  "................................................................................",
  "................................................................................",
  "................................................................................",
  "................................................................................",
  "................................................................................",
  "................................................................................",
  "................................................................................",
  "................................................................................",
  "................................................................................",
  "........................................................................------..",
  "......................--------........--------........--------............DD....",
  ".DD.......................................................................DD.DD.",
  ".DD.......................................................................DD.DD.",
  ".DD.......................................................................DD.DD.",
  ".DD.......................................................................DD.DD.",
  "################################################################################",
  "================================================================================",
  "================================================================================",
  "================================================================================",
  "================================================================================"
 ],
 "playerSpawn": {
  "x": 48,
  "y": 216
 },
 "entities": [
  {
   "type": "healer",
   "x": 190,
   "y": 216
  },
  {
   "type": "elder",
   "x": 320,
   "y": 216
  },
  {
   "type": "blacksmith",
   "x": 450,
   "y": 216
  },
  {
   "type": "merchant",
   "x": 560,
   "y": 216
  }
 ],
 "props": {
  "music": "overworld"
 },
 "triggers": [
  {
   "x": 4,
   "y": 196,
   "w": 18,
   "h": 36,
   "event": "door",
   "once": false,
   "props": {
    "room": "throne",
    "x": 560,
    "y": 216
   }
  },
  {
   "x": 586,
   "y": 190,
   "w": 28,
   "h": 42,
   "event": "portal",
   "once": false,
   "props": {}
  },
  {
   "x": 60,
   "y": 160,
   "w": 90,
   "h": 72,
   "event": "talk",
   "once": true,
   "props": {
    "conversation": "town-entry"
   }
  },
  {
   "x": 612,
   "y": 200,
   "w": 20,
   "h": 32,
   "event": "door",
   "once": false,
   "props": {
    "room": "vault",
    "x": 48,
    "y": 216
   }
  }
 ]
}
