{
  "name": "town",
  "tileSize": 8,
  "legend": {
    "#": "rockTop",
    "=": "rock",
    "-": "platform",
    "D": "gate",
    "O": "portal"
  },
  "tiles": [
    "................................................................................",
    "................................................................................",
    "................................................................................",
    "................................................................................",
    "................................................................................",
    "................................................................................",
    "................................................................................",
    "................................................................................",
    "................................................................................",
    "................................................................................",
    "................................................................................",
    "................................................................................",
    "................................................................................",
    "................................................................................",
    "................................................................................",
    "................................................................................",
    "................................................................................",
    "................................................................................",
    "................................................................................",
    "................................................................................",
    "................................................................................",
    "................................................................................",
    "................................................................................",
    "........................................................................------..",
    "D.....................--------........--------........--------............OO....",
    "D.........................................................................OO....",
    "D.........................................................................OO....",
    "D.........................................................................OO....",
    "D.........................................................................OO....",
    "#########################----###################################################",
    "=========================....===================================================",
    "=========================....===================================================",
    "=========================....===================================================",
    "================================================================================"
  ],
  "playerSpawn": {
    "x": 48,
    "y": 216
  },
  "entities": [
    {
      "type": "healer",
      "x": 190,
      "y": 216
    },
    {
      "type": "elder",
      "x": 320,
      "y": 216
    },
    {
      "type": "blacksmith",
      "x": 450,
      "y": 216
    },
    {
      "type": "merchant",
      "x": 560,
      "y": 216
    }
  ],
  "props": {
    "music": "overworld",
    "map": {
      "x": 13,
      "y": 2
    }
  },
  "triggers": [
    {
      "x": 0,
      "y": 196,
      "w": 8,
      "h": 36,
      "event": "door",
      "once": false,
      "props": {
        "room": "throne"
      }
    },
    {
      "x": 586,
      "y": 190,
      "w": 28,
      "h": 42,
      "event": "portal",
      "once": false,
      "props": {}
    },
    {
      "x": 60,
      "y": 160,
      "w": 90,
      "h": 72,
      "event": "talk",
      "once": true,
      "props": {
        "conversation": "town-entry"
      }
    },
    {
      "x": 632,
      "y": 200,
      "w": 8,
      "h": 32,
      "event": "door",
      "once": false,
      "props": {
        "room": "mountain"
      }
    },
    {
      "x": 200,
      "y": 240,
      "w": 32,
      "h": 16,
      "event": "door",
      "once": false,
      "props": {
        "room": "underground",
        "fallIn": true
      }
    }
  ]
}
