{
  "name": "underground",
  "tileSize": 8,
  "legend": {
    "#": "rockTop",
    "=": "rock",
    "-": "platform",
    "A": "doorway"
  },
  "tiles": [
    "=====...====================================================",
    "=====...====================================================",
    "=====...====================================================",
    "=====...====================================================",
    "=...-------................................................=",
    "=..........................................................=",
    "=..........................................................=",
    "=..........................................................=",
    "=...---------..............................................=",
    "=..........................................................=",
    "=..........................................................=",
    "=..........................................................=",
    "=........---------.........................................=",
    "=..........................................................=",
    "=..........................................................=",
    "=..........................................................=",
    "=...---------..............................................A",
    "=..........................................................A",
    "=..........................................................A",
    "=..........................................................A",
    "############################################################",
    "============================================================",
    "============================================================",
    "============================================================"
  ],
  "playerSpawn": {
    "x": 48,
    "y": 140
  },
  "entities": [],
  "triggers": [
    {
      "x": 40,
      "y": 8,
      "w": 24,
      "h": 32,
      "event": "door",
      "props": {
        "room": "town"
      }
    },
    {
      "x": 464,
      "y": 128,
      "w": 8,
      "h": 32,
      "event": "door",
      "props": {
        "room": "vault"
      }
    }
  ],
  "props": {
    "map": {
      "x": 13,
      "y": 4
    }
  }
}
