{
  "name": "underground",
  "tileSize": 8,
  "legend": {
    "#": "rockTop",
    "=": "rock",
    "-": "platform",
    "D": "gate"
  },
  "tiles": [
    "=====...====================================================",
    "=====...====================================================",
    "=====...====================================================",
    "=====...====================================================",
    "=..........................................................=",
    "=..........................................................=",
    "=..........................................................=",
    "=..........................................................=",
    "=..........................................................=",
    "=..........................................................=",
    "=..........................................................=",
    "=..........................................................=",
    "=..........................................................=",
    "=..........................................................=",
    "=..........................................................=",
    "=..........................................................=",
    "=..........................................................=",
    "=..........................................................=",
    "=..........................................................=",
    "=..........................................................=",
    "############################################################",
    "============================================================",
    "============================================================",
    "============================================================"
  ],
  "playerSpawn": {
    "x": 48,
    "y": 134
  },
  "entities": [],
  "triggers": [
    {
      "x": 40,
      "y": 128,
      "w": 24,
      "h": 32,
      "event": "door",
      "once": false,
      "props": {
        "room": "town"
      }
    },
    {
      "x": 464,
      "y": 128,
      "w": 8,
      "h": 32,
      "event": "door",
      "once": false,
      "props": {
        "room": "vault"
      }
    }
  ],
  "props": {
    "map": {
      "x": 13,
      "y": 4
    }
  }
}
