{
  "name": "vault",
  "tileSize": 8,
  "legend": {
    "#": "rockTop",
    "=": "rock",
    "-": "platform",
    "D": "gate",
    "x": "spikes"
  },
  "tiles": [
    "==============================================================================================================",
    "==============================================================================================================",
    "=............................................................................................................=",
    "=............................................................................................................=",
    "=............................................................................................................=",
    "=............................................................................................................=",
    "=............................................................................................................=",
    "=............................................................................................................=",
    "=............................................................................................................=",
    "=............................................................................................................=",
    "=............................................................................................................=",
    "=............................................................................................................=",
    "=...................................................----.....................................................=",
    "=............................................................................................................=",
    "=............................................................................................................=",
    "=............................................................................................................=",
    "=............................................................................................................=",
    "=............................................................................................................=",
    "=............................................................................................................=",
    "=............................................................................................................=",
    "=............................................................................................................=",
    "=............................................................................................................=",
    "=......................................------................................................................=",
    "=............................................................................................................=",
    "=.....................................................................----.....----..........................=",
    "=.DD.........................................................................................................=",
    "=.DD...............................####......................................................................=",
    "=.DD...............................====......................................................................=",
    "=.DD........xxxxxxxxxxxxxxxxxxxxxxx====.....................................xxxxxxxxxxxxx....................=",
    "=###########=======================#########################################=============####################=",
    "==============================================================================================================",
    "==============================================================================================================",
    "==============================================================================================================",
    "=============================================================================================================="
  ],
  "playerSpawn": {
    "x": 48,
    "y": 216
  },
  "entities": [
    {
      "type": "platform",
      "x": 100,
      "y": 200,
      "props": {
        "w": 28,
        "h": 6,
        "dx": 60,
        "dy": 0,
        "period": 5
      }
    },
    {
      "type": "platform",
      "x": 210,
      "y": 216,
      "props": {
        "w": 28,
        "h": 6,
        "dx": 0,
        "dy": -60,
        "period": 4,
        "phase": 1
      }
    },
    {
      "type": "platform",
      "x": 360,
      "y": 200,
      "props": {
        "w": 24,
        "h": 6,
        "dx": 0,
        "dy": -90,
        "period": 6
      }
    },
    {
      "type": "lever",
      "x": 424,
      "y": 86,
      "props": {
        "switch": "vault-a"
      }
    },
    {
      "type": "barrier",
      "x": 480,
      "y": 176,
      "props": {
        "switch": "vault-a",
        "w": 8,
        "h": 56
      }
    },
    {
      "type": "plate",
      "x": 566,
      "y": 190,
      "props": {
        "switch": "vault-b"
      }
    },
    {
      "type": "barrier",
      "x": 728,
      "y": 176,
      "props": {
        "switch": "vault-b",
        "w": 8,
        "h": 56,
        "linger": 3.5
      }
    },
    {
      "type": "chest",
      "x": 780,
      "y": 210
    },
    {
      "type": "chest",
      "x": 820,
      "y": 210
    },
    {
      "type": "chest",
      "x": 856,
      "y": 210
    }
  ],
  "props": {
    "music": "depths",
    "map": {
      "x": 14,
      "y": 2
    }
  },
  "triggers": [
    {
      "x": 12,
      "y": 200,
      "w": 20,
      "h": 32,
      "event": "door",
      "once": false,
      "props": {
        "room": "town"
      }
    },
    {
      "x": 44,
      "y": 180,
      "w": 60,
      "h": 52,
      "event": "talk",
      "once": true,
      "props": {
        "conversation": "vault-entry"
      }
    }
  ]
}
